#################
#               #
#       O        #
#   X####       #
#    #      X   #
#    #   O   P  #
#    #          #
#  O        X   #
#               #
#################
